%%%%%%%%%%
%.........%
%....i....%
%P......G.%
%%%%%%%%%%
