%%%%%%%%%%%%%%%%%%%%
%....%........%....%
%.%%.%.%%%%%%.%.%%.%
%.%..............%.%
%.%.%%.%%  %%.%%.%.%
%......%G  G%......%
%.%.%%.%%%%%%.%%.%.%
%.%...i..........%.%
%.%%.%.%%%%%%.%.%%.%
%....%...P....%...i%
%%%%%%%%%%%%%%%%%%%%
